Проверка на языки 
 
Как сказать "спасибо" на разных языках.
Английский: Thank you.
Африкаанс: Dankie (стандартная фраза). Ta (на детском языке).
Голландский: Dank u (официально). Dank je (неофициально).
Финский: Kiitos.
Французский: Merci.
Немецкий: Vielen Dank (официально). Danke (неофициально).
Иврит: Toda Raba.
Исландский: Takk.
Японский: Domo arigato (официально). Arigato (неофициально).
Корейский: Kam-Sam-Ni-Da.
Корейский:고맙습니다 (ко-мап-сум-ни-да).
Креольский: Tenki.
Латынь: Gratias ago.
Малайский: Terima kasih.
Вьетнамский: cám ơn (感恩).
Малайялам: നന
ദ
 (на-нни).
Мандаринский диалект китайского: 谢谢 (шьейе).
Норвежский: Takk/Tusen takk/Takk skal du ha.
Персидский:متشکرم (мотешаккерам).
Португальский: Obrigado (к мужчинам) / obrigada(к женщинам).
Румынский: Multumesc (официально). Mersi (неофициально).
Сербский: Hvala.
Синдхи: Meherbaani.
Сингальский: Sthuthi.
Испанский: Gracias.
Шведский: Tack.
Тагальский/филиппинский: Maraming salamat.
Турецкий: Teşekkürler.
Урду: Shukriya (شکریہ).

